NO assets/walls/fgata-va.png
WE assets/walls/javgonza.png


EA assets/walls/robrodri.png



SO assets/walls/mcordoba.png
F 255,0,0





C 0,255,0
11111111111111111111
10000000000000000001
10000000000000000001
10000000000000000001
10000000000000000001
10000000000000000001
10000000000000000001
10000000000000000001
10000000000000000001
10000000000000000001
1000000000W000000001
10000000000000000001
10000000000000000001
10000000000000000001
10000000000000000001
10000000000000000001
10000000000000000001
10000000000000000001
10000000000000000001
11111111111111111111
