NO assets/walls/Robgonza.png
F 128,128,128
EA assets/walls/debug_walls/east.png
WE assets/walls/debug_walls/west.png
SO assets/walls/debug_walls/south.png

C 188,215,221









              1111111111111
              1000000000001
              1000000000001
              1000000000001
              1000000000001
              1000000000001
              1000000000001
              1000000000001
              1000000000001
              1000000000001
              1000000000001
              1000000000001
              1111111111111








111111111111111111111111111111111111111111111111111111111111111111111111111111111111111111111111
100000000000000000000000000000000000000000000011100000000000000000000000000000000000000000000011
100000000000111110000011111000000010000000000001100000000000111110000011111000000010000000000001
100000001111100001101110000110000010000000000001100000001111100001101110000110000010000000000001
100000010000000001100000000110000010000000000001100000010000000001100000000110000010000000000001
100000110000000001100000000110000010000000000001100000110000000001100000000110000010000000000001
100000111110001111101000111110000010000000000001100000111110001111101000111110000010000000000001
10000000000000000000000000000000001000W00000001110000000000000000000000000000000001000W000000011
10000001111111111111111111111111010000000000011 10000001111111111111111111111111010000000000011
1000000000000000000000000000000000000000000011  1000000000000000000000000000000000000000000011
100000000011110000011111000000000010000000001   100000000011110000011111000000000010000000001
100000000100000111110000110000000010000000001   100000000100000111110000110000000010000000001
100000001100001000000000110000000001100000001   100000001100001000000000110000000001100000001
10000000111110100000000011000000000010000000111 10000000111110100000000011000000000010000000111
10000000000000011111000111110000000011000000001 10000000000000011111000111110000000011000000001
10010000000000000000000000000000000010100000001 10010000000000000000000000000000000010100000001
10010000000000000000000000000000000010010000001 10010000000000000000000000000000000010010000001
10010111111111111100000000000000000010001000001 10010111111111111100000000000000000010001000001
10010000000000000000011111000000000010000100001 10010000000000000000011111000000000010000100001
10010000000000000111110000110000000010000010001 10010000000000000111110000110000000010000010001
10010000000000001000000000110000000010000001001 10010000000000001000000000110000000010000001001
10010000000000011000000000110000000010000001001 10010000000000011000000000110000000010000001001
10010000000000011111000111110000000000000000001 10010000000000011111000111110000000000000000001
10010000011111000000000000000000000000W00000001 10010000011111000000000000000000000000W00000001
10000000000000000000000000000000000000000000001 10000000000000000000000000000000000000000000001
11111111111111111111111111111111111111111111111 11111111111111111111111111111111111111111111111
111111111111111111111111111111111111111111111111111111111111111111111111111111111111111111111111
100000000000000000000000000000000000000000000011100000000000000000000000000000000000000000000011
100000000000111110000011111000000010000000000001100000000000111110000011111000000010000000000001
100000001111100001101110000110000010000000000001100000001111100001101110000110000010000000000001
100000010000000001100000000110000010000000000001100000010000000001100000000110000010000000000001
100000110000000001100000000110000010000000000001100000110000000001100000000110000010000000000001
100000111110001111101000111110000010000000000001100000111110001111101000111110000010000000000001
10000000000000000000000000000000001000W00000001110000000000000000000000000000000001000W000000011
10000001111111111111111111111111010000000000011 10000001111111111111111111111111010000000000011
1000000000000000000000000000000000000000000011  1000000000000000000000000000000000000000000011
100000000011110000011111000000000010000000001   100000000011110000011111000000000010000000001
100000000100000111110000110000000010000000001   100000000100000111110000110000000010000000001
100000001100001000000000110000000001100000001   100000001100001000000000110000000001100000001
10000000111110100000000011000000000010000000111 10000000111110100000000011000000000010000000111
10000000000000011111000111110000000011000000001 10000000000000011111000111110000000011000000001
10010000000000000000000000000000000010100000001 10010000000000000000000000000000000010100000001
10010000000000000000000000000000000010010000001 10010000000000000000000000000000000010010000001
10010111111111111100000000000000000010001000001 10010111111111111100000000000000000010001000001
10010000000000000000011111000000000010000100001 10010000000000000000011111000000000010000100001
10010000000000000111110000110000000010000010001 10010000000000000111110000110000000010000010001
10010000000000001000000000110000000010000001001 10010000000000001000000000110000000010000001001
10010000000000011000000000110000000010000001001 10010000000000011000000000110000000010000001001
10010000000000011111000111110000000000000000001 10010000000000011111000111110000000000000000001
10010000011111000000000000000000000000W00000001 10010000011111000000000000000000000000W00000001
10000000000000000000000000000000000000000000001 10000000000000000000000000000000000000000000001
11111111111111111111111111111111111111111111111 11111111111111111111111111111111111111111111111
111111111111111111111111111111111111111111111111111111111111111111111111111111111111111111111111
100000000000000000000000000000000000000000000011100000000000000000000000000000000000000000000011
100000000000111110000011111000000010000000000001100000000000111110000011111000000010000000000001
100000001111100001101110000110000010000000000001100000001111100001101110000110000010000000000001
100000010000000001100000000110000010000000000001100000010000000001100000000110000010000000000001
100000110000000001100000000110000010000000000001100000110000000001100000000110000010000000000001
100000111110001111101000111110000010000000000001100000111110001111101000111110000010000000000001
10000000000000000000000000000000001000W00000001110000000000000000000000000000000001000W000000011
10000001111111111111111111111111010000000000011 10000001111111111111111111111111010000000000011
1000000000000000000000000000000000000000000011  1000000000000000000000000000000000000000000011
100000000011110000011111000000000010000000001   100000000011110000011111000000000010000000001
100000000100000111110000110000000010000000001   100000000100000111110000110000000010000000001
100000001100001000000000110000000001100000001   100000001100001000000000110000000001100000001
10000000111110100000000011000000000010000000111 10000000111110100000000011000000000010000000111
10000000000000011111000111110000000011000000001 10000000000000011111000111110000000011000000001
10010000000000000000000000000000000010100000001 10010000000000000000000000000000000010100000001
10010000000000000000000000000000000010010000001 10010000000000000000000000000000000010010000001
10010111111111111100000000000000000010001000001 10010111111111111100000000000000000010001000001
10010000000000000000011111000000000010000100001 10010000000000000000011111000000000010000100001
10010000000000000111110000110000000010000010001 10010000000000000111110000110000000010000010001
10010000000000001000000000110000000010000001001 10010000000000001000000000110000000010000001001
10010000000000011000000000110000000010000001001 10010000000000011000000000110000000010000001001
10010000000000011111000111110000000000000000001 10010000000000011111000111110000000000000000001
10010000011111000000000000000000000000W00000001 10010000011111000000000000000000000000W00000001
10000000000000000000000000000000000000000000001 10000000000000000000000000000000000000000000001
11111111111111111111111111111111111111111111111 11111111111111111111111111111111111111111111111
