0000000000000000000000000000
0000000000000000000000000000
0000000000111111100000000000
0000000000100W00000000000000
0000000000111111100000000000
0000000000000000000000000000
