NO assets/walls/Robgonza.png
F 128,128,128
EA assets/walls/debug_walls/east.png
WE assets/walls/debug_walls/west.png
SO assets/walls/debug_walls/south.png

C 188,215,221

11111111111111111111111111111111111111111111111
10000000000000000000000000000000000000000000001
10000000000000000000011111000000000000000000001
10000000000000000111110000110000000000000000001
10000000000000001000000000110000000000000000001
10000000000000011000000000110000000000000000001
10000000000000011111000111110000000000000000001
10000000000000000000000000000000000000E00000001
10000000000000000000000000000000000000000000001
11111111111111111111111111111111111111111111111
