11111111111111111111111
100000000000000000000011111111111
100000000000000000000000000000011
100000000000000000000000000000001
100000000000000000000000000000001
100000000000000000000000000000011
10000000000000000000000000011111
1000000000000000000011111111
111111111111111111111
