NO assets/walls/Robgonza.png
F 128,128,128
EA assets/walls/debug_walls/east.png
WE assets/walls/debug_walls/west.png
SO assets/walls/debug_walls/south.png

C 188,215,221

11111111111111111111111111111111111111111111111
10000100100000110000000000000000010000000000001
10111100001101111000000000000000010000000000001
10100010111000000111110000110010010101011101001
10001010100000001000000000110101010100111111011
10101110111000011000000000110111111101100101001
10100000000000011111000111110010101101101101011
10101111101010110000000000000000000000000000001
1N100000000000000000000000000000000000000000001
11111111111111111111111111111111111111111111111
