1111111111
1000000001
1100000011
1110000111
1111011111
111111111
